PPPPPPPPPPPPPPPPPPPPP
PMMMPMMMMMFMPMMMMMMMP
PMPMMMPPPPPMMMPPPPPMP
PMPMPWMMMMMMPMMMMMMMP
PMPMPPMPPPMPPPMPPPPMP
PMMMMMMMPMMMPMMMMMMWP
PMPMPPPMMMPMMMPMPPMPP
PMPMMMPPMPPPMPPMMMMPP
PMPPPMPMMMIMMMPMPPMMP
PBMMMMMMPPDPPMMMMPPMP
PMPPMPPMP1  PMPPMMMMP
PMMMMMPMPPPPPMPMMPPMP
PMPPPMMMMMFMMMPMPPPVP
PMMMPPPMPPPPPMMMMMMMP
PPPMMMPMPMJMPMPPPPMPP
PMMWPMMMMMPMMMMPMMMPP
PMPPPMPPPMPPMPMMMPMMP
PMMMMMMMPMMMMPPMPPPMP
PMPPPPPMMMPPPPMMMWPMP
PMMMMMMMPMMMMMMPPMMMP
PPPPPPPPPPPPPPPPPPPPP

