PPPPPPPPPPPPPPPPPPPPP
PMMMPMMMMMFMPMMMMMMMP
PMPMMMPPPPPMMMPPPPPMP
PMPMPWMMMMMMPMMMMMMMP
PMPMPPMPPPMPPPMPPPPMP
PMMMMMMMPMMMPMMMMMMWP
PMPMPPPMMMPMMMPMPPMPP
PMPMMMPPMPPPMPPMMMMPP
PPPPPMPMMMIMMMPMPPMMP
PBMMMMMMPP PPMMMMPPMP
PMPPMPPMP   PMPPMMMMP
PMMMMMPMPPPPPMPMMPPMP
PMPPPMMMMMFMMMPMPPPVP
PMMMPPPMPPPPPMMMMMMMP
PPPMMMPMPM MPMPPPPPPP
PMMWPMMMMMPMMMMPMMMPP
PMPPPMPPPMPPMPMMMPMMP
PMMMMMMMPMMMMPPMPPPMP
PMPMPPPMMMPPPPMMMWPMP
PMPMMMMMPMMMMMMPPMMMP
PPPPPPPPPPPPPPPPPPPPP

