PPPPPPPPPPPPPPPPPPPPP
PMMMMMMMMMFMMMMMMMMWP
PMPPPPPPPPMPPPPPPPPMP
PMWMMMMMMMMMMMMMMMMMP
PMPPPMPMPMPMPMPMPPPMP
PMMMPMPMPMMMPMPMPMMMP
PMPMPMPMMIPMMMPMPMPMP
PMPMPMPMPPPPPMPMPMPMP
PMPMMMMMMMMMMMMMMMPMP
PMPPPMPMPPDPPMPMPPPMP
PMMMMMPMP12 PMPMMBMMP
PMPPPMPMPPPPPMPMPPPMP
PMPMMMMMMMFMMMMMMMPMP
PMPMPMPMPPPPPMPMPMPMP
PMPMPMPMMMJMMMPMPMPMP
PMMMPMPMPMPMPMPMPMWMP
PMPPPMPMPMPMPMPMPPPMP
PMMWMMMMMMMMMMMMMMMMP
PMPPPPPPPPMPPPPPPPPMP
PMMMMMMMMMVMMMMMMMMMP
PPPPPPPPPPPPPPPPPPPPP

