PPPPPPPPPPPPPPPPPPPPP
PMMMMMMMVMMMMMMMMMMMP
PMPPPPMPMPPPMPMPPPPMP
PMMMMMMPMMFMMPMMMMWMP
PMPPPMPPMPPPMPPMPPPMP
PMWMMMMPMMMMMPMMMMMMP
PMPPPPMPMPPPMPMPPPPMP
PMMMMPMPMPPPMPMPMMMMP
PMPPMMMMMM4MMMMMMPPMP
PMMPMPPMPPDPPMPPMPMMP
PPMPBMPMP123PMPMBPMPP
PPMPPMPMPPPPPMPMPPMPP
PMMMMMMMMMFMMMMMMMMMP
PMPPPPMPPPPPPPMPPPPMP
PMPPPPMMMMJMMMMPPPPMP
PMMMMMMPMPPPMPMMMMWMP
PMPPPMPPMPPPMPPMPPPMP
PMMMMMMPMMMMMPMMMMMMP
PMPPPPMPMPPPMPMPPPPMP
PMWMMMMMMMMMMMMMMMMMP
PPPPPPPPPPPPPPPPPPPPP