PPPPPPPPPPPPPPPPPPPPP
PMMMMMMMVMMMMMMMMMMMP
PMPPPPMPMPPPMPMPPPPMP
PMMMMMMPMMFMMPMMMMWMP
PMPPPMPPMPPPMPPMPPPMP
PMWMMMMPMMMMMPMMMMMMP
PMPPPPMPMPPPMPMPPPPMP
PMMMMPMPMPPPMPMPMMMMP
PMPPMMMMMMMMMMMMMPPMP
PMMPMPPMPPDPPMPPMPMMP
PPMPBMPMP12 PMPMBPMPP
PPMPPMPMPPPPPMPMPPMPP
PMMMMMMMMMFMMMMMMMMMP
PMPPPPMPPPPPPPMPPPPMP
PMPPPPMMMMJMMMMPPPPMP
PMMMMMMPMPPPMPMMMMWMP
PMPPPMPPMPPPMPPMPPPMP
PMMMMMMPMMMMMPMMMMMMP
PMPPPPMPMPPPMPMPPPPMP
PMWMMMMMMMMMMMMMMMMMP
PPPPPPPPPPPPPPPPPPPPP